    #####          
    #   #          
    #$  #          
  ###  $##         
  #  $ $ #         
### # ## #   ######
#   # ## #####  ..#
# $  $          ..#
##### ### #@##  ..#
    #     #########
    #######   
;
####
 ##
;
#### #######
######
